111111111111111
100000000010001
100P000C0010001
100000001110001
100000010000001
1111111C0000001
1000000C0000001
1000000C0000001
100000000000001
100000000000001
100000000000001
100000000000001
100000000000001
100000000000001
1000000E0000001
111111111111111