111111111
101E00001
1010P0001
101C0C001
111111111