111111111111111111111111111111
1110C00C00C0111111111111100001
100000000000000111111100000001
100C00000C000000111110000C0001
100000000000000000100000000001
1100C0000000C00000P0000000C001
111000000C000000000000C0000001
1111100000C0000000E00000000C01
1111111000000C000000000000C001
111111111111111111111111111111
111111111111111111111111111111
111111111111111111111111111111
111111111111111111111111111111
111111111111111111111111111111
111111111111111111111111111111
111111111111111111111111111111
111111111111111111111111111111