1111111111111111111111111111111111111
1110C00C00C011111111111110000C0000111
1000000000000001111111000000000C00001
100C00000C000000111110000C00000C00001
1000000000000000001000000000000C00001
1100C0000000C00000P0000000C0000000011
111000000C000000000000C00000000000111
1111100000C0000000000000000C000011111
1111111000000C000000000000C0001111111
1111111110000000C0000000C000111111111
111111111110000C000CCC000011111111111
1111111111111000C00000001111111111111
11111111111111100000C0111111111111111
1111111111111111100011111111111111111
111111111111111111E111111111111111111
1111111111111111111111111111111111111