11111111111111111111
1000C000011111111111
10P00000011111111111
100CCC000111111E1111
100000C00CCCCCCC1111
11111111111111111111
