1111111111
1000CE0001
10P00P0001
1000000001
1000000001
1111111111