111111111111
1P00C000E111
111111111111
