111111111111
1P00E000C001
111111111111
